00000000000000000000
00000000000000000000
00000000000000000000
00000111111111000000
00000120020021000000
00000100000001000000
00000100030001000000
00000100000001000000
00000101101101000000
00000100300301000000
00000103000001000000
00000100000001000000
00000101030001000000
00000120000021000000
00000111111111000000
00000000000000000000
00000000000000000000
00000000000000000000
00000000000000000000
00000000000000000000
					