00000000000000000000
00000000000000000000
00000000000000000000
00000000000000000000
00000111111111000000
00000100000001000000
00000100333301000000
00000100000301000000
00000100030001000000
00000111101111000000
00000100000001000000
00000122220221000000
00000111111111000000
00000000000000000000
00000000000000000000
00000000000000000000
00000000000000000000
00000000000000000000
00000000000000000000
00000000000000000000
					