##############################
#                            #
#                            #
#                            #
#                            #
#             #              #
#             #              #
#             #              #
#             #              #
#             #              #
#     ################       #
#             #              #
#             #              #
#             #              #
#             #              #
#             #              #
#                            #
#                            #
#                            #
##############################
