##############################
#                            #
#                            #
#                            #
#                            #
#     ####                   #
#                            #
#                            #
#                            #
#                            #
#            ####            #
#                            #
#                            #
#                            #
#                            #
#                  ####      #
#                            #
#                            #
#                            #
##############################
